E . # . # . . # . .
# . . # . # . . # .
. . # . # . # . . .
# . . # . # . . # .
. # . # . # . # . .
# . . . . . # . . .
. # . # . . . . S .
# . . . . . . . . .