E . . # # # . # .
. # . # . # b c .
# . . a # . # # .
d . # # # # . . .
# . # . b . . . #
. . . . # . . . .
# . d . . a # . S
. # # . . . # c .